#########################
#S# #     #       #     #
# # # # # ##### # # #####
# #   # # #     # #     #
# ##### # # ##### ### # #
#       #   #   #   # # #
############# # ### # # #
# #       #   #     # # #
# # # ### # ########### #
# # # #   #   #         #
# # # # ##### # ####### #
# # # # #   #   #   #   #
# # # ### # ##### ### ###
# # #     #     #   # # #
# # ######### # # # # # #
# #   # #     # # #   # #
# ### # # ##### # ##### #
#   #   #     # # #     #
# # ### ##### ### # # # #
# #   # #   #   # # # # #
# # # # # # ### # ### # #
# # # #   #   # # #   # #
# # ######### # # # ### #
# #           #     #  E#
#########################